########################################
#1-------------------------------------#
############-----------------------#####
#--------------------------------------#
#--------------------------------------#
#-----###########----------------------#
#--------------------------------------#
#--aaaaaaaa----------------------------#
#----########--------------------------#
#--------------------------------------#
#--------aaabab------------------------#
#--------------------------------------#
#--------------------------------------#
#--------------------------------------#
#---dddssssssss------------------------#
#--------------------------------------#
#--------------------------------------#
#---------err--------------------------#
#-------------------------------@-----w#
########################################