-//TODO
-------------b
#1-----------b
########aaaaab
-------------b
h----------ccc
eeeeeee------i
ggggggggggg--i
-------------i
-------------i
-------------i
-------------i
-------------i
-----------^-i
ttttttt#######
vote for trump