---------build your own map.    toggle the correct letters to create your path.
------------------------------------------------------------------------------------------#
------------------------------------------------------------------------------------------#
1-----------------------------------------------------------------------------------------#
####################################################################################------#
------------------------------------------------------------------------------------------#
------------------------------------------------------------------------------------------#
------------------------------------------------------------------------------------------#
------------------------------------------------------------------------------------------#
------------------------------------------------------------------------------------------#
------------------------------------------------------------------------------------------#
------------------------------------------------------------------------------------------#
------------------------------------------------------------------------------------------#
------------------------------------------------------------------------------------------#
												    hello there 0 abcabcabcabcabcabcabcabc#