3333333333333333333333333333333333333333
3------------1-------------------------3
333333333333-----------------------33333
3--------------------------------------3
3--------------------------------------3
3-----33333333333----------------------3
3--------------------------------------3
3--aaaaaaaa----------------------------3
3----33333333--------------------------3
3--------------------------------------3
3--------aaabab------------------------3
3--------------------------------------3
3--------------------------------------3
3--------------------------------------3
3---dddssssssss------------------------3
3--------------------------------------3
3--------------------------------------3
3---------err--------------------------3
3-----------------@-------------------23
3333333333333333333333333333333333333333