########################################
#------------1-------------------------#
############-----------------------#####
#--------------------------------------#
#--------------------------------------#
#-----###########----------------------#
#--------------------------------------#
#--aaaaaaaa----------------------------#
#----########--------------------------#
#--------------------------------------#
#--------aaabab------------------------#
#--------------------------------------#
#--------------------------------------#
#--------------------------------------#
#---dddssssssss------------------------#
#--------------------------------------#
#--------------------------------------#
#---------err--------------------------#
#-------------------------------------2#
########################################